STUDENT REGISTERED FOR EXAM VENUE:

STU00001	......................
STU00002	......................
STU00003	......................
STU00004	......................
STU00005	......................
STU00006	......................
STU00007	......................
STU00008	......................
STU00009	......................
STU000010	......................
