STUDENT REGISTERED FOR EXAM VENUE:

STU0001	......................
STU0002	......................
STU0003	......................
STU0004	......................
STU0005	......................
